###############################################################################
#...#...@...#.................................................................#
#...#.......#.................................................................#
#...####.####.................................................................#
#.............................................................................#
#.............................................................................#
#.............................................................................#
#.............................................................................#
#.............................................................................#
#.............................................................................#
#.............................................................................#
#.............................................................................#
#.............................................................................#
#.............................................................................#
#.............................................................................#
#.............................................................................#
#.............................................................................#
#.............................................................................#
#.............................................................................#
###############################################################################